TILEMAP
36 28 							-- Size of tile map in tiles
16 32						-- Tile size & block size
images/FinalMap.png	-- Tilesheet
2 2 
8999999999999999999999999997
1111111111111111111111111111
2222222222222222222222222222
2222222222222222222222222222
2222222222222222222222222222
2222222222222222222222222222
1111111111111111111111111111
2222222222222222222222222222
2222222222222222222222222222
2222222222222222222222222222
1111111111111111111111111111
2222222222222222222222222222
2222222222222222222222222222
2222222222222222222222222222
1111111111111111111111111111
2222222222222222222222222222
2222222222222222222222222222
2222222222222222222222222222
1111111111111111111111111111
2222222222222222222222222222
2222222222222222222222222222
2222222222222222222222222222
1111111111111111111111111111
2222222222222222222222222222
2222222222222222222222222222
3666666666666666666666666666
4555555555555555555555555555
5555555555555555555555555555
