TILEMAP
36 28 							-- Size of tile map in tiles
16 64 						-- Tile size & block size
images/Berserk4.png	-- Tilesheet
2 2 
111111111111111111111111111111111111
222222222222222222222222222222222222
333333333333333333333333333333333333
444444444444444444444444444444444444
555555555555555555555555555555555555
666666666666666666666666666666666666
777777777777777777777777777777777777
888888888888888888888888888888888888
999999999999999999999999999999999999
aaaaaaaaaaaaaaaaaaaaaaaaaaaaaaaaaaaa
bbbbbbbbbbbbbbbbbbbbbbbbbbbbbbbbbbbb
cccccccccccccccccccccccccccccccccccc
222222222222222222222222222222222222
111111111111111111111111111111111111
222222222222222222222222222222222222
222222222222222222222222222222222222
222222222222222222222222222222222222
111111111111111111111111111111111111
222222222222222222222222222222222222
222222222222222222222222222222222222
222222222222222222222222222222222222
111111111111111111111111111111111111
222222222222222222222222222222222222
222222222222222222222222222222222222
666666666666666666666666666666666666
455555555555555555555555555555555555
555555555555555555555555555555555555
111111111111111111111111111111111111