TILEMAP
32 32 							-- Size of tile map in tiles
16 16 							-- Tile size & block size
images/bloqueTransparente16.png 	-- Tilesheet
1 1								-- Number of tiles in tilesheet
00000000000000000000000000000000
01000000000000000000000000000000
01100000000000000000000000000000
01100000000000000000000000000000
01100000000000000000000000000000
01100000000000000000000000000000
01000000000000000000000001111110
01000000000000000000000001111110
01000000000000000000000001111110
01000000000000000000000001111110
01000000000000000000000001111110
01000000000000000000000001111110
01000000000000000000000001111110
01000000000000000000000001111110
01000000000000000000000001111110
01000000000000000000000001111110
01000000000000000000000001111110
01000000000000000000000001111110
01000000000000000000000001111110
01000000000000000000000001111110
01111111111111111111111111111110
01111111111111111111111111111110
01111111111111111111111111111110
01111111111111111111111111111110
01111111111111111111111111111110
01111111111111111111111111111110
01111111111111111111111111111110
01111111111111111111111111111110
01111111111111111111111111111110
00000000000000000000000000000000
00000000000000000000000000000000
00000000000000000000000000000000