TILEMAP
26 16
16 16
images/tiles.png
16 16
11111111111111111111111111
22222222222222222222222222
33333333333333333333333333
11111111111111111111111111
11111111111111111111111111
11111111111111111111111111
11111111111111111111111111
55555555555555555555555555
11111111111111111111111111
11111111111111111111111111
11111111111111111111111111
11111111111111111111111111
11111111111111111111111111
11111111111111111111111111
11111111111111111111111111
11111111111111111111111111